24 F    805
24 M    298
31 F    1538
31 M    558
41 F    855
41 M    338
51 F    361
51 M    189
56 F    350
56 M    146
62 F    278
62 M    102
7 F     144
7 M     78
